Level 1
7 11
XXXXXXX
XXXXXXX
XXXXXXX
X^XX*XX
X..X..X
XX.XX.X
XX.XX.X
XS.!B.X
XXXXXXX
XXXXXXX
XXXXXXX
4
4