Level 2
7 11
XXXXXXX
XXXXXXX
XXXXXXX
X^...*X
X.XXX.X
X.XXX.X
X.XXX.X
XB...SX
XXXXXXX
XXXXXXX
XXXXXXX
4
4