Level 5
7 11
XXXXXXX
XXXXXXX
XXXXXXX
X*.$.^X
X.&.X$X
X..!..X
X&S..XX
XB...XX
XXXXXXX
XXXXXXX
XXXXXXX
7
7